.#..#......|#
.....#..#.#.#
..#...##..#.#
..........#.#
#......#..#.#
#.#..#.#..#.#
.....#......#
..#.#..#.#..#
........#...#
.#.....#....#
........#...#
@.##.#.#....#