.#..#......|#
.....#..#.#.#
..#...##..#.#
..........#.#
#......#..#.#
#.#..#-#..#.#
.....#......#
..#.#..#.#.-#
........#...#
-#.....#....#
........#...#
@.##.#.#....#