.#.........|#
.....#..#.#.#
..#.-.##-.#.#
..........#.#
#......#..#.#
#.#-.#.#..#.#
-....#......#
..#.#..#.#..#
...-....#.-.#
.#.......-..#
........#...#
@.##.#......#