.#.........|#
-....#..-.#.#
..#.-.##..#.#
..-......-#.#
#....-.#..#.#
#.#-.#.#-.#.#
-....#......#
..#.#..#.#..#
...-....#.-.#
.#...-...-..#
...-....#...#
@.##.#......#